wwwwwwwwwwwwwwwwwwwwwwwwwwwwwwwwwwwwww
wwwwwwwwwwwwwwwwwwwwwwwwwwwwwwwwwwwwww
wwww000ww00000ww2--000w0000wwwwwwwwwww
00w0000000000000---0000000000000wwwwww
0000000000000000---0000000000000000www
0000000000000000000000000000000000000w
000001--00000000000001--00000000000000
00000---0000000000000---00000000000000
00000---0000000000000---00000000000000
00000000000000000000000000000000000000
00000000000000000000000000000000000000
00000000000000000000000000000000000000
00000000000000000000000000000000000000
00000000000000000000000000000000000000
000000000000001--4---00000000000000000
00000000000000-------00000000000000000
00000000000000-------00000000000000000
00000000000000000----00000000000000000
00000000000000000000000000000000000000
00000000000000000000000000000000000000
00000000000000000000000000000000000000
00000000000000000000000000000000000000
w0000000000000000000000000000000000000
ww000000000000000000000000000000000000
ww0000000000000000000000001--3--00000w
www00000000000000000000000------0000ww
wwwww000000000000000000000------00wwww
wwwwww0000000000000000000000wwwwwwwwww
wwwwwww00000000000000000wwwwwwwwwwwwww