wwwwwwwwwwwwwwwwwwwwwwwwwwwwwwwwwwwwww
wwwwwwwwwwwwwwwwwwwwwwwwwwwwwwwwwwwwww
wwww000ww00000ww2--3--w0000wwwwwwwwwww
00w0000000000000------0000000000wwwwww
0000000000000000------0000000000000www
0000000000000000000000000000000000000w
000001--00000000000001--00000000000000
00000---0000000000000---00000000000000
00000---0000000000000---00000000000000
00000000000000000000000000000000000000
00000000000000000000000000000000000000
00000000000000000000000000000000000000
00000000000000000000000000000000000000
00000000000000000000000000000000000000
000000000000001--4---00000000000000000
00000000000000-------00000000000000000
00000000000000-------00000000000000000
00000000000000000----00000000000000000
00000000000000000000000000000000000000
00000000000000000000000000000000000000
00000000000000000000000000000000000000
00000000000000000000000000000000000000
00000000000000000000000000000000000000
0000000000000000000000000000000000000w
00ww0000000000000000000000000000000www
wwwww0000ww00000w000000000000000wwwwww
wwwwww00wwww000www000w000w000wwwwwwwww
wwwwwwwwwwwwwwwwwwwwwwwwwwwwwwwwwwwwww
wwwwwwwwwwwwwwwwwwwwwwwwwwwwwwwwwwwwww
