wwwwwwwwwwwwwwwwwwwwwwwwwwwwwwwwwwwwww
wwwwwwwwwwwwwwwwwwwwwwwwwwwwwwwwwwwwww
wwww2--ww002--ww2--3--w3--0wwwwwwwwwww
00w0---0000---00------0---000000wwwwww
0000---0000---00------0---000000000www
000000001--1--00000000000000000000000w
000001--------00000001--00000000000000
00000---------0000000---00000000000000
00000---1--4---1--000---00000000000000
000001------------00000000000000000000
00000-------------00000000000000000000
00000---1------1--00000000000000000000
000001-----1--0---00000000000000000000
00000---------0---00000000000000000000
00000---1-----1--4---00000000000000000
00000000---1---------00000000000000000
00000000-------------00000000000000000
00000000000---000----00000000000000000
000000000000000005----0000000000000000
00000000000000000-----0000000000000000
00000000000000000-----0000000000000000
00000000000000000-----0000000000000000
00000000000000000000000000000000000000
0000000000000000000000000000000000000w
00ww000000003--0002--03--0000000000www
wwwww0000ww0---0w0---0---0000000wwwwww
wwwwww00wwww---www---w---w000wwwwwwwww
wwwwwwwwwwwwwwwwwwwwwwwwwwwwwwwwwwwwww
wwwwwwwwwwwwwwwwwwwwwwwwwwwwwwwwwwwwww
