wwwwwwwwwwwwwwwwwwwwwwwwwwwwwwwwwwwwww
wwwwwwwwwwwwwwwwwwwwwwwwwwwwwwwwwwwwww
wwww2--ww2--00ww2--3--w3--0wwwwwwwwwww
00w0---00---02--------0---3--3--wwwwww
02-----00---0---------0---------000www
0---000000000---1--0000000------00000w
0---01--1--1--00---001--00000000000000
00000---------00---00-s-00000000000000
00000---------1--1--0---1--00000000000
000001--1--1--------0000---00000000000
00000---------------0000---00000000000
00000---------1--1--1--1--1--000000000
000001--1--1-----------------000000000
00000------------------------000000000
00000---------1--4---4---5----5----000
00000000000000---------------------000
00000000000000---------------------000
00000000000000000------------------000
000000000000000004---4---5----5----000
00000000000000000------------------000
00000000000000000------------------000
02--0000000000000------------------000
0---00002--0002--000000000000000000000
0---02-----2-----00000000000000000000w
00ww0------------000000000000000000www
wwwww---0ww---00w000000000000000wwwwww
wwwwww00wwww000www000w000w000wwwwwwwww
wwwwwwwwwwwwwwwwwwwwwwwwwwwwwwwwwwwwww
wwwwwwwwwwwwwwwwwwwwwwwwwwwwwwwwwwwwww
